11111111111111111111
10010000000000000111
10000111110000000011
100011E1000000111001
10000000011110000001
100000C1111CC0000001
11100CC000C00C000001
1100C1C000000C001111
110CCCCC0000C0000011
100000C0100C00000011
1P0000C010CCCC000111
11111111111111111111
