11111111111111111111111111111111
1P0000000000000000000000000000E1
100000000CC0000000000CC000000001
100000CCCCCCCC0000CCCCCCCC000001
100000CCCCCCCCC00CCCCCCCCC000001
10000CCCCCCCCCCCCCCCCCCCCCC00001
10000CCCCCCCCCCCCCCCCCCCCCC00001
10000CCCCCCCCCCCCCCCCCCCCCC00001
100000CCCCCCCCCCCCCCCCCCCC000001
1000000CCCCCCCCCCCCCCCCCC0000001
100000000CCCCCCCCCCCCCC000000001
1000000000CCCCCCCCCCCC0000000001
1000000000000CCCCCCC000000000001
10000000000000CCCC00000000000001
100000000000000CC000000000000001
11111111111111111111111111111111