1111111111111111111111111111111111
111111011111111000011111111111E111
111111CC111101C0110001111111100011
111110C001110011100000011111110011
1110001100111111001110001111111011
1111111110001100011111100111111011
1C11111111100001111111110011110011
1001111111111111111111100000100111
110001111111C111111100001110000111
1111001111110011110001111111001111
1001101111011000100111111111101111
10001001110011100011110C0C11101111
1011100001100110111111C00011101111
1110001100011100111111100011000111
1P00011110000000111111110000011111
1111111111111111111111111111111111