111111111111111111
100000000000000001
100000000000000001
100000000000000001
100000000000000001
100000000000000001
100000000000000001
100000000000000001
10000000CE00000001
100000000000000001
100000000000000001
100000000000000001
100000000000000001
10000000P000000001
100000000000000001
100000000000000001
100000000000000001
111111111111111111