111111111111
1E0000000001
111110000001
10P010001001
100010011001
100000001101
101110000101
10C111000001
111111111111
