111111111111111111
1E00000000000000C1
111111111111111101
1C0000000000000001
101111111111111111
1000000000000000C1
111111111111111101
1P0000000000000001
111111111111111111