11111111111111111111111111111111
10000000000000000000000000000001
10000000000000000000000000000001
10000011111000000000011011000001
100001000001000000001000001000E1
10111100C00111111111100C00111111
10000100000100000000100000100001
10000011011000011000011111000001
1C0C0C000000000110000000C0C0C001
10C0C0C000000011110000000C0C0C01
100C0C0C000001C11C10000000C0C0C1
10000000011000000000011000000001
11100000001100000000110000000001
10000000000111111111100000000001
1P100000000000000000000000000001
11111111111111111111111111111111
